11111111111111111111111111112
10000000000001100000000000012
10111101111101101111011111012
10111101111101101111011111012
10000000000000000000000000012
10111101101111111101101111012
10111101101111111101101111012
