11111111111111111111111111112
10000000000001100000000000012
10111101111101101111011111012
10111101111101101111011111012
10000000000000000000000000012
10111101101111111101101111012
10111101101111111101101111012
10000001100001100001100000012
11111101111101101111101111112
00000001100000000001100000002
11111101101111111101101111112
11111101100000000001101111112

11111101100000000001101111112
11111101101111111101101111112
00000001100000000001100000002
11111101111101101111101111112
11111101111101101111101111112
10000001100001100001100000012
10111101101111111101101111012
10111101101111111101101111012
10000000000000000000000000012
10111101111101101111011111012
10111101111101101111011111012
10000000000001100000000000012
11111111111111111111111111112